╔═══════════╗                  
║      ■    ║                   
║ ╔═══════╦═╩═╦═══╦═══════════╗
║ ║       ║   ║   ║           ║
║ ║ ╬ ╬ ╬ ║ ╬ ║ ╬ ║ ╔═══╦═══╬ ║
║ ║ ║ ║ ║ ║ ║ ║ ║ ║ ║   ║     ║
║ ╬ ║ ╚═╝ ║ ║ ╬ ║ ║ ╬ ╬ ║ ╬═╬ ║
║   ║     ║ ║   ║     ║ ║     ║
║ ╬ ╚═══╗ ║ ╚═══╬ ╬═══╝ ║ ╔═╗ ║
║ ║                     ║ ║ ║ ║
║ ╚═══╗ ╔═══════╬ ╬═══╬═╝ ║ ║ ║
║     ║ ║             ║   ║ ║ ║
║ ╬ ╬ ╬ ║ ╬═══╬ ╬═╬ ╬═╠═╬ ╬ ╬ ║
║ ║ ║   ║             ║¤      ║
║ ║ ║ ╚═╝ ╬ ╬ ╬═════╬ ║ ╬═══╗ ║
║ ║ ║       ║         ║     ║ ║
║ ╬ ╬ ╔═══╬ ╬ ╬═╬ ╬═╬ ╠═══╬ ║ ║
║           ║   ║     ║     ║ ║
║ ╔═╗ ╬ ╬ ╬ ╬ ╬ ╬═╬ ╬ ║ ╔═╬ ╠═╣
║ ║   ║ ║             ║ ║   ║ ║
║ ╬ ╬ ║ ║ ╬ ╬ ╬ ╬═══╬ ║ ║ ╬═╣ ║
║     ║ ║   ║     ¤ ║ ║ ║   ║ ║
║ ╔═╬ ╬ ║ ╬ ╬ ╬ ╬═══╬ ║ ╠═╬ ║ ║
║ ║     ║   ║ ║ ║     ║ ║   ║ ║
║ ╚═════╬ ╬ ║ ╬ ╬ ╬═╬ ║ ╠═══╝ ║
║       ║¤  ║   ║ ║ ║ ║ ║     ║
║ ╔═══╬ ╚═╬ ╬═══╬ ╬ ╬ ╬ ╬ ╬ ╬ ║
║ ║             ║         ║ ║ ║
╚═╩═════════════╩═══╩═════╩═╝ ║
                       ·      ║
                       ═══════╝