╔═══════════╗    ╣ ╩ ╬ ╦ ╠ ═ ║ 
║      ■    ║ ·  ╗ ╔  ╝ ╚  ¤ ■ 
║ ╔═══╦═══╦═╩═════╦═══╦═══╦═══╗
║ ║                           ║
║ ║ ╬ ╬ ╬ ╬ ╬ ╬ ╬ ╬ ╬ ╬ ╬ ╬ ╬ ║
║ ║                           ║
║ ╬ ╬ ╬ ╬ ╬ ╬ ╬ ╬ ╬ ╬ ╬ ╬ ╬ ╬ ║
║                             ║
║ ╬ ╬ ╬ ╬ ╬ ╬ ╬ ╬ ╬ ╬ ╬ ╬ ╬ ╬ ║
║                           ║ ║
║ ╬ ╬ ╬ ╬ ╬ ╬ ╬ ╬ ╬ ╬ ╬ ╬ ╬ ║ ║
║                           ║ ║
║ ╬ ╬ ╬ ╬ ╬ ╬ ╬ ╬ ╬ ╬ ╬ ╬ ╬ ╬ ║
║                             ║
║ ╬ ╬ ╬ ╬ ╬ ╬ ╬ ╬ ╬ ╬ ╬ ╬ ╬ ╬ ║
║                           ║ ║
║ ╬ ╬ ╬ ╬ ╬ ╬ ╬ ╬ ╬ ╬ ╬ ╬ ╬ ║ ║
║                           ║ ║
║ ╬ ╬ ╬ ╬ ╬ ╬ ╬ ╬ ╬ ╬ ╬ ╬ ╬ ╠═╣
║                           ║ ║
║ ╬ ╬ ╬ ╬ ╬ ╬ ╬ ╬ ╬ ╬ ╬ ╬ ╬ ║ ║
║                           ║ ║
║ ╬ ╬ ╬ ╬ ╬ ╬ ╬ ╬ ╬ ╬ ╬ ╬ ╬ ║ ║
║                           ║ ║
║ ╬ ╬ ╬ ╬ ╬ ╬ ╬ ╬ ╬ ╬ ╬ ╬ ╬ ╬ ║
║                             ║
║ ╬ ╬ ╬ ╬ ╬ ╬ ╬ ╬ ╬ ╬ ╬ ╬ ╬ ╬ ║
║                           ║ ║
╚═══╩═══╩═══╩═══╩═══╩═══════╝ ║
                       ·      ║
                       ═══════╝